11111111111111111111
1000E000100000000001
10000000100000000001
1000000010P000000001
100C0000000000000001
11111111100000000001
10000010000000C00001
10000011110000000001
10000000000000000001
10000011111100000001
10000000000100000001
11111110000111111111
11111111100000000001
11111110000111111111
10000000000000000001
10000001111111111101
10000000001100000001
10000000001100000001
10000000001000000001
11111111111111111111