1111111111
1P10000001
1010000001
100P000001
1000000C11
1C01000001
1010000001
1000000001
1000CE0001
1111111111