111111111111111111111
111111111100001111111
1000000000P1101111111
101111011101101111111
101110001101101111111
101111101101101111111
100000001101111111111
111101111101111111111
111100000001111111111
111111111111111111111